###############
#     @       #
#             #
#             #
#    *        #
#             #
#           * #
#             #
#     *       #
#             #
#  *          #
#             #
#       x     #
#             #
###############
